11111111111111111111
13000000001000100041
10111111102010101111
10010000100010100001
12000110111100111101
12121000100001000001
12112021001210011101
12110001011120100001
12000101000000101111
11111001111121000121
10000010000010021121
10111110111000111121
10200010001012122221
10101011101011101211
10001010001012101211
11111010211000001221
10000010211110211121
10111100010001111121
10000001000100022221
11111111111111111111